2111111111111111111111111111111111111111111111111111111111111111111111111111111111111111111111111113
4666666666666666666666666666666666666666666666666666666666666666666666666666666666666666666666666669
4666666666666666666666666666666666666666666666666666666666666666666666666666666666666666666666666669
4666666666666666666666666666666666666666666666666666666666666666666666666666666666666666666666666669
4666666666666666666666666666666666666666666666666666666666666666666666666666666666666666666666666669
4666666666666666666666666666666666666666666666666666666666666666666666666666666666666666666666666669
4666666666666666666666666666666666666666666666666666666666666666666666666666666666666666666666666669
4666666666666666666666666666666666666666666666666666666666666666666666666666666666666666666666666669
4666666666666666666666666666666666666666666666666666666666666666666666666666666666666666666666666669
4666666666666666666666666666666666666666666666666666666666666666666666666666666666666666666666666669
4666666666666666666666666666666666666666666666666666666666666666666666666666666666666666666666666669
4666666666666666666666666666666666666666666666666666666666666666666666666666666666666666666666666669
4666666666666666666666666666666666666666666666666666666666666666666666666666666666666666666666666669
4666666666666666666666666666666666666666666666666666666666666666666666666666666666666666666666666669
4666666666666666666666666666666666666666666666666666666666666666666666666666666666666666666666666669
4666666666666666666666666666666666666666666666666666666666666666666666666666666666666666666666666669
4666666666666666666666666666666666666666666666666666666666666666666666666666666666666666666666666669
4666666666666666666666666666666666666666666666666666666666666666666666666666666666666666666666666669
4666666666666666666666666666666666666666666666666666666666666666666666666666666666666666666666666669
4666666666666666666666666666666666666666666666666666666666666666666666666666666666666666666666666669
4666666666666666666666666666666666666666666666666666666666666666666666666666666666666666666666666669
4666666666666666666666666666666666666666666666666666666666666666666666666666666666666666666666666669
4666666666666666666666666666666666666666666666666666666666666666666666666666666666666666666666666669
4666666666666666666666666666666666666666666666666666666666666666666666666666666666666666666666666669
4666666666666666666666666666666666666666666666666666666666666666666666666666666666666666666666666669
4666666666666666666666666666666666666666666666666666666666666666666666666666666666666666666666666669
4666666666666666666666666666666666666666666666666666666666666666666666666666666666666666666666666669
4666666666666666666666666666666666666666666666666666666666666666666666666666666666666666666666666669
4666666666666666666666666666666666666666666666666666666666666666666666666666666666666666666666666669
4666666666666666666666666666666666666666666666666666666666666666666666666666666666666666666666666669
4666666666666666666666666666666666666666666666666666666666666666666666666666666666666666666666666669
4666666666666666666666666666666666666666666666666666666666666666666666666666666666666666666666666669
4666666666666666666666666666666666666666666666666666666666666666666666666666666666666666666666666669
4666666666666666666666666666666666666666666666666666666666666666666666666666666666666666666666666669
4666666666666666666666666666666666666666666666666666666666666666666666666666666666666666666666666669
4666666666666666666666666666666666666666666666666666666666666666666666666666666666666666666666666669
4666666666666666666666666666666666666666666666666666666666666666666666666666666666666666666666666669
4666666666666666666666666666666666666666666666666666666666666666666666666666666666666666666666666669
4666666666666666666666666666666666666666666666666666666666666666666666666666666666666666666666666669
4666666666666666666666666666666666666666666666666666666666666666666666666666666666666666666666666669
4666666666666666666666666666666666666666666666666666666666666666666666666666666666666666666666666669
4666666666666666666666666666666666666666666666666666666666666666666666666666666666666666666666666669
4666666666666666666666666666666666666666666666666666666666666666666666666666666666666666666666666669
4666666666666666666666666666666666666666666666666666666666666666666666666666666666666666666666666669
4666666666666666666666666666666666666666666666666666666666666666666666666666666666666666666666666669
4666666666666666666666666666666666666666666666666666666666666666666666666666666666666666666666666669
4666666666666666666666666666666666666666666666666666666666666666666666666666666666666666666666666669
4666666666666666666666666666666666666666666666666666666666666666666666666666666666666666666666666669
4666666666666666666666666666666666666666666666666666666666666666666666666666666666666666666666666669
5777777777777777777777777777777777777777777777777777777777777777777777777777777777777777777777777778

